10
-
0 0 3 1 0 E 0 0 0 0 
0 0 1 1 1 1 1 1 1 0 
0 0 0 0 D E 0 0 1 0 
0 0 0 0 D E 0 0 1 0 
A 0 0 M 1 1 E 0 0 0 
1 1 1 1 1 0 0 0 0 0 
4 4 4 0 1 0 0 0 2 0 
4 4 4 0 B 0 0 0 0 0 
1 1 B 1 0 0 0 0 0 0 
E 0 0 0 0 0 0 0 0 0 

0 0 0 0 0 0 0 0 0 0 
1 1 1 1 1 0 E 0 0 0 
0 0 1 0 1 0 0 0 0 0 
0 9 1 0 1 1 1 1 1 0 
0 0 1 E 1 0 0 0 0 0 
1 0 1 0 1 0 1 0 3 0 
0 0 1 0 1 0 1 0 0 0 
0 0 1 0 1 0 1 0 0 0 
2 0 1 0 1 0 0 1 0 1 
0 0 0 0 0 0 0 0 0 0 

0 0 0 0 0 0 0 0 0 0 
0 0 1 1 1 0 0 0 2 0 
0 0 0 0 1 9 0 0 0 0 
0 E 0 0 1 1 1 1 1 1 
0 0 0 0 0 0 0 0 0 0 
1 1 1 1 0 0 0 0 0 0 
0 0 0 1 0 0 0 0 0 0 
0 0 0 1 0 1 1 1 1 1 
0 0 0 E 0 1 0 0 0 2 
3 0 0 1 0 0 0 0 0 0 

1 1 1 0 0 E 0 0 3 0 
2 0 1 0 0 0 0 0 0 0 
0 0 1 1 1 1 1 1 1 0 
0 0 0 0 0 0 0 0 0 0 
1 1 1 0 1 1 1 1 1 0 
0 0 0 0 1 2 0 0 1 0 
1 1 1 0 1 0 0 0 1 0 
0 0 1 0 1 0 1 1 1 0 
0 0 1 0 1 0 E 0 0 0 
0 0 0 0 1 0 0 0 0 3 

0 0 1 0 0 0 0 0 0 0 
0 3 1 0 E 0 0 0 0 0 
0 1 0 0 0 0 0 0 0 0 
0 1 0 0 0 0 0 0 0 0 
0 1 0 1 1 1 1 1 0 0 
0 1 0 0 0 0 3 1 0 0 
0 1 1 0 1 0 0 1 0 0 
0 0 1 0 1 1 1 1 0 0 
0 9 1 0 E 0 0 1 0 0 
0 0 1 0 0 0 0 1 2 0 
 		
2 0 0 0 0 0 0 0 0 0 
1 0 1 0 0 0 0 1 0 0 
0 E 0 1 0 0 0 1 0 0 
0 0 0 1 1 1 1 1 0 0 
0 1 1 1 0 0 0 1 0 0 
0 0 0 1 0 E 0 1 1 1 
1 1 0 1 0 1 0 1 0 0 
0 0 0 1 0 1 1 1 0 0 
0 1 1 1 0 1 0 0 0 0 
0 0 0 0 0 0 0 0 0 3 

0 0 0 0 0 0 0 0 0 0 
0 3 1 1 1 1 1 1 0 2 
0 1 0 0 0 0 0 0 1 1 
0 1 0 0 0 1 1 0 0 0 
0 1 1 1 1 0 0 1 E 0 
0 0 0 E 0 2 0 1 0 0 
0 1 1 1 0 0 0 1 0 0 
0 1 0 0 1 1 1 0 0 0 
0 1 0 0 0 0 0 0 0 0 
0 1 9 0 0 0 0 0 0 0 
 
0 0 0 0 0 0 0 0 0 3 
1 1 1 0 E 0 0 0 0 0 
0 2 0 1 1 0 0 0 1 1 
0 0 0 1 0 0 E 0 E 0 
0 0 0 1 1 1 1 1 1 1 
0 0 1 0 0 0 3 1 0 0 
0 0 1 0 0 1 1 0 E 0 
0 0 0 0 0 0 1 0 0 0 
0 0 1 1 1 1 1 0 0 0 
0 0 0 0 0 0 0 0 0 0 
 
0 2 0 1 0 0 0 0 0 0 
0 0 0 1 0 0 1 0 2 0 
0 0 0 1 0 0 1 0 0 0 
0 0 0 1 0 0 1 1 1 1 
0 0 0 1 0 0 0 0 0 0 
0 E 0 1 0 0 E 0 0 0 
0 0 0 1 0 1 1 1 1 0 
0 0 0 1 0 1 0 0 0 0 
0 0 0 1 1 1 0 0 0 0 
0 0 0 0 0 0 0 0 0 0 
 
0 0 1 0 0 0 0 1 3 0 
0 3 1 0 2 0 0 1 0 0 
0 0 1 0 0 0 0 1 0 0 
A 9 1 0 0 0 0 1 0 0 
1 1 0 0 0 0 0 1 0 0 
0 0 0 0 E 0 0 1 0 0 
1 D D D 1 0 0 1 0 0 
0 0 0 0 1 1 1 0 0 0 
0 0 0 0 0 E 0 0 0 0 
0 0 0 0 0 0 0 0 0 0
