10
1
-
0 0 0 1 0 E 0 0 E 0 
0 0 1 1 1 1 1 1 1 0 
0 0 0 0 0 0 0 0 1 0 
0 0 0 0 0 0 0 0 1 0 
0 0 0 0 1 1 0 0 0 0 
1 1 1 1 1 0 0 0 0 0 
0 0 0 0 1 0 0 0 2 0 
0 0 0 0 0 0 0 0 0 0 
1 1 0 1 0 0 0 0 0 0 
0 E 0 E 0 0 0 0 0 0 

9 0 0 0 0 0 0 0 0 0 
1 1 1 1 1 0 E 0 0 0 
0 0 1 0 1 0 0 0 0 0 
0 0 1 0 1 1 1 1 1 0 
0 0 1 E 1 0 0 0 0 0 
1 0 1 0 1 0 1 0 3 0 
0 0 1 0 1 0 1 0 0 0 
0 0 1 0 1 0 1 0 0 0 
2 0 1 0 1 0 0 1 0 1 
0 0 E 0 E 0 0 0 0 0 

0 0 0 0 0 0 0 0 0 0 
0 0 1 1 1 0 0 0 2 0 
0 0 0 0 1 9 0 0 0 0 
0 E 0 0 1 1 1 1 1 1 
0 0 0 0 0 0 0 0 0 0 
1 1 1 1 0 0 0 E 0 0 
0 0 0 1 0 0 0 0 0 0 
0 0 0 1 0 1 1 1 1 1 
0 0 0 E 0 1 E 0 0 2 
3 0 0 1 0 0 0 0 0 0 

2 1 0 0 0 E 0 0 3 0 
0 1 0 0 0 0 0 0 0 0 
0 1 1 1 1 1 1 1 1 0 
0 E 0 0 0 0 0 0 0 0 
1 1 1 0 1 1 1 0 1 1 
0 E 0 0 1 2 1 0 1 0 
1 1 1 0 1 0 1 0 1 0 
0 0 1 0 1 0 1 0 0 0 
0 0 1 0 1 0 E 0 0 0 
0 0 0 0 1 0 0 0 0 3 

0 3 0 1 0 0 0 0 0 0 
0 0 1 0 E 0 0 0 0 0 
0 1 0 0 0 0 0 0 0 0 
0 1 0 0 0 0 0 0 0 0 
0 1 0 1 1 1 1 1 0 0 
E 1 0 0 0 0 3 1 0 0 
0 1 1 0 1 0 0 1 0 0 
0 0 1 0 1 1 1 1 E 0 
0 9 1 0 E 0 0 1 0 0 
0 0 1 0 0 0 0 1 2 0 
 		
2 0 0 0 0 0 0 0 0 0 
1 1 1 0 0 0 0 1 E 0 
0 E 0 0 0 0 0 1 0 0 
0 0 0 1 1 1 1 1 0 0 
0 1 1 1 0 0 0 1 0 0 
0 0 0 1 0 E 0 1 1 1 
1 1 E 1 0 1 0 1 0 0 
0 0 0 1 0 1 1 1 0 0 
0 1 1 1 0 1 0 0 0 0 
0 0 0 0 0 0 0 0 0 3 

0 0 0 0 0 0 0 0 2 0 
0 3 1 1 1 1 1 1 0 0 
0 1 0 0 0 0 0 0 1 1 
0 1 0 0 0 1 1 0 0 0 
0 1 1 1 1 0 0 1 E 0 
E 0 0 E 0 2 0 1 0 0 
0 1 1 1 0 0 0 1 0 0 
0 1 0 0 1 1 1 0 0 0 
0 1 0 0 E 0 0 0 0 0 
0 1 9 0 0 0 0 0 0 0 
 
0 0 0 0 0 0 0 0 0 3 
1 1 1 0 E 0 0 0 1 1 
0 2 0 1 1 0 0 0 E 0 
0 0 0 1 0 0 E 0 0 0 
0 0 0 1 1 1 1 1 1 1 
0 0 1 0 0 0 3 1 0 0 
E 0 1 0 0 1 1 0 E 0 
0 0 0 0 0 0 1 0 0 0 
0 0 1 1 1 1 1 0 0 0 
0 0 0 0 E 0 0 0 0 0 
 
0 0 0 1 0 0 0 0 0 0 
0 3 0 1 0 0 1 0 2 0 
0 0 0 1 0 0 1 0 0 0 
0 0 0 1 0 0 1 1 1 1 
0 0 0 1 0 0 0 0 0 0 
0 E 0 1 0 0 E 0 0 0 
0 0 0 1 0 1 1 1 1 0 
0 0 0 1 0 1 0 0 0 0 
2 0 0 1 1 1 0 E 0 0 
0 0 0 0 E 0 0 0 0 0 
 
0 0 0 0 0 0 0 1 3 0 
0 0 0 0 0 0 0 1 0 0 
0 0 0 0 0 0 0 1 0 0 
0 0 0 0 0 0 0 1 0 0 
0 0 0 0 0 0 0 1 0 0 
0 0 0 0 E 0 0 1 0 0 
1 1 0 E 1 0 0 1 E E 
9 0 1 0 1 1 1 0 0 0 
0 0 1 0 0 E 0 0 0 0 
3 0 1 0 0 E 0 0 0 0
